
1111111111111111111
1422222222222222221
1222222222222222221
1222222222222222221
1222222222222222221
1222222222222222221
1222222222222222221
1222222222252222221
1222222222222222221
1222222222222222221
1222222222222222221
1222222222222222221
1222222222222222221
1222222222222222221
1111111111111111111
-
0000000000000000000
0000000000000000000
0000000000000000000
0000000000000000000
0000000000000000000
0000001111110000000
0000001022210000000
0000001022210000000
0000001014100000000
0000001012100000000
0000000012100000000
0000000012100000000
0000000012100000000
0000000015100000000
0000000011100000000
-
0000000000000000000
0000000000000000000
0000000000000000000
0000000000000000000
0000000000000000000
0000000000000000000
0000000000000000000
0000000000000000000
0000000000000000000
0111111111111111000
0152222242222221000
0111111111111111000
0000000000000000000
0000000000000000000
0000000000000000000
-
1000000000000000000
0000000000000000000
0000000000000000000
0000000000000000000
0000000000000000000
0000000000000000000
0000000000000111000
0000001111100151000
0001111222111121110
0111122222222122210
0142222222222122210
0111122212222222210
0000111111111111110
0000000000000000000
0000000000000000000
-
0000000000000000000
0000000000000000000
0111111111111111000
0122222222222221000
0121111111111121111
0121115222222232221
0121111111111121121
0121111111111141121
0121111111111111121
0121111221122221121
0122222222222222221
0111112222221111111
0000011111111000000
0000000000000000000
0000000000000000000
