0000000000000000000
0000000000000000000
0000000000000000000
0000000000000000000
0000000000000000000
0000000000000000000
0000000000000111000
0000001111100151000
0001111222111121110
0111122222222122210
0142222222222122210
0111122212222222210
0000111111111111110
0000000000000000000
0000000000000000000
-
0000000000000000000
0000000000000000000
0111111111111111000
0122222222222221000
0121111111111211110
0121115222222322210
0121111111111211210
0121111111111211210
0121111111111411210
0121111111111111210
0121111221122221110
0122222222222222210
0000011111110000000
0000000000000000000
0000000000000000000